vertebrate -- высокоорганизованный
endowment -- вклад (генов)
possession -- владение (языком)
emergence -- появление (способности говорить)
palliative -- болеутоляющее; средство, лечащее сиптомы
constrain -- принуждать; стеснять; заключать в тюрьму
insight -- глубинное понимание
rod-shaped -- палочкообразный (вирус)
forth -- вперёд; выбить; наружу; далее; ниже
purveyor -- поставщик
hip -- бок; расстраивать (уныние, разг.)
premise -- предпосылка; предполагать
elucidation -- выяснение; разъяснение; толкование (текста)
inexplicable -- необъяснимый
manifestation -- раскрытие
inextricable -- безнадёжно
combustion -- беспорядок; волнение; горение (окисление); ожог
split up -- дробить; разделяться
well over -- далеко за; намного больше
supplement -- дополнять; дополнение; присадка
to be woven throughout -- переплетён с (description of molecules)
pace -- ход; темп (of discovery); задавать темп
prerequisite -- требуемое условие
entity -- сущность
cleavage -- раскалывание; дробление
strung -- взвинченный; напряжённый
emerge -- всплывать
abudant -- изобильный; распространённый
medium -- условия; атмосфера
slight -- лёгкий (tendency)
profound -- основательный
cohesive -- связанный; связующий; способный к сцеплению
adjacent -- прилегающий; смежный
vicinity -- близость; соседство
bear -- нести (charge (заряд))
overlap -- перекрывание; наложение
apt -- уместный
flicker -- мерцание
confer -- придавать
lattice -- решётчатая структура; ставить решётку
account for -- объяснять
distinction -- распознавание; отличительная особенность; заслуга
wax -- воск
inferior -- плохой (по качеству)
leap -- скачок (политика Большого Скачка)
decree -- декрет (указ)
boon -- благо; приятный (климат)
vulture -- коршун
pursue -- бежать; следовать (плану)
foray -- вылазка; мародёрство
submission -- рассмотрение
scuttle -- избегать опасности; стремление избежать опасность
sustain -- подкрепить; поддержать
strive (for) -- порываться; прилагать усилия
ferocity -- свирепость
benevolence -- щедрость; благоволение
tuition -- обучение
meagre -- бедный; тощий (income)
stride -- идти широким шагом
pilfer -- стащить; уворовать
rogue -- жулик
repulsion -- оттлакивание (частиц)
facilitate -- содействовать
cage -- клетка (тюремная)
bulk -- объём; сваливать в кучу; куча (bulk phase -- объёмная фаза)
intrinsic -- внутренний (interaction); врождённый; наследственный; встроенный; сущий; свойственный чему-либо
moiety -- доля; половина; часть; дрожайшая половина (супруга (шутливо))
transient -- безработный бродяга; неустановившийся временный режим (transient dipole caused by random fluctuations of the electron density)
draw closer -- приникать
repel -- вызывать неприязнь; оттолкнуть
depict -- описывать
proximity -- близость
simultaneous -- синхронный
hopping -- скакание
alter -- видоизменять
semipermeable -- полупронецаемый
passage -- движение
shrinck -- ёжиться
swell -- бухнуть
inward -- прибывающий
distend -- надувать
burst -- разрыв; взрыв
interstitial -- внутретканевый
stiffen -- делать жёстким
wilt -- увядать
digestion -- пищеварение
drooping -- понижение (частоты)
feathery -- пушистый (перья)
foe -- недруг
depraved -- растлённый; распущенный
warp -- искажать; перекашиваться; совратить (с пути)
unwavering -- непоколебимый; решительный
implement -- внедрять; реализовывать
give in -- сдаваться; уступать
fruition -- достижение желанной цели; наслаждение достигнутым; результат
hardship -- лишение; трудности
lapdog -- собака на поводке; прихвостень
lurk -- таиться; скрываться в засаде
wipe -- вытирать; ликвидировать; наносить поражение
concession -- уступка; скидка (в цене)
instantaneous -- мгновенный
extent -- распространение; степень
scope -- границы; диапазон; сфера
retain -- запечатлять; сохранять (control)
at any instant -- в любой конкретный момент
and vice versa -- и наоборот
arbitrarily -- произвольно
coincide -- сходиться; равняться
coincidence -- совпадение
saliva -- слюна
vinegar -- уксус
amplify -- усиливать (сигнал)
dilute -- разреженный; слабый (раствор)
conform -- согласовываться
apparent -- явный; очевидный; кажущийся
side chain -- боковая цепь; побочная цепь (в молекулах)
digestive -- кишечный; пищеварительный; способствующий пищеварению
vigorous -- решительный (протест); бодрое (занятие)
exhale -- выдыхать
inhale -- вдыхать
eliminate -- выделяться
circumvent -- обмануть; обойти
byproduct -- побочный продукт
insulate -- изолированный
frigid -- безразличный; холодный
resemble -- иметь сходство; напоминать
redundant -- избыточный
parentheses -- круглые скобки (круглая скобка -- parenthesis)
